8 8 4 1 6 6 3 4 1 8 4 0 6 0 3 0 
[330 334 4, 310 206 3]
[440 378 2, 468 133 3, 496 368 3, 392 179 4, 490 322 3, 373 37 3]

4 7 1 7 1 1 8 4 5 5 5 7 2 8 3 7 
[330 334 4, 258 266 2, 222 258 3, 190 226 3, 282 146 3, 210 210 4, 38 334 3]
[416 152 4, 237 53 3, 485 267 4, 471 86 3, 1 243 2, 115 359 3, 456 35 2, 260 232 4, 94 6 3, 275 272 4, 429 233 2, 498 197 4, 470 120 4, 68 114 4, 342 302 4, 143 191 3, 137 150 3, 236 101 2, 51 270 2, 289 8 3, 278 351 2]

4 7 1 7 1 2 8 4 5 8 5 7 2 8 3 7 
[330 334 3, 362 334 4, 394 366 3, 434 378 3, 410 378 3, 338 310 2, 354 370 4, 346 194 4]
[174 12 3, 347 27 2, 224 39 4, 140 117 2, 383 48 2, 376 287 2, 447 74 4, 10 391 3, 356 183 2, 441 383 3, 190 65 2, 449 224 3, 372 367 3, 393 175 2, 217 27 3, 113 273 4, 378 219 4, 36 385 3, 293 11 3, 364 279 2, 91 382 3, 452 255 4, 491 262 2, 85 314 2]

2 7 1 7 1 1 1 4 5 5 5 7 2 8 3 7 
[330 334 4, 298 302 2, 266 298 2, 282 182 2, 322 218 2, 242 194 2, 378 14 4, 442 14 2]
[368 80 4, 469 280 4, 146 321 2, 375 125 3, 357 289 2, 45 259 3, 260 347 3, 301 262 2, 149 106 4, 434 99 4, 467 14 3, 240 295 3, 433 103 2, 163 85 4, 350 281 2, 140 286 3, 17 118 2, 191 335 2, 423 191 2, 360 197 3, 451 151 3, 222 289 2, 274 160 2, 3 276 4]

4 7 1 7 1 1 8 4 5 5 5 7 2 8 3 7 
[330 334 3, 362 330 4, 330 330 2, 402 302 3, 486 366 2, 482 302 3, 450 238 3, 462 338 2, 346 318 4]
[248 230 4, 63 104 3, 325 17 3, 489 85 4, 472 85 4, 177 156 2, 195 74 3, 442 260 3, 379 28 2, 273 386 4, 197 349 2, 165 262 4, 389 125 4, 282 267 3, 27 26 2, 304 270 4, 99 18 2, 343 84 3, 100 375 3, 351 86 2, 256 23 4, 380 367 2, 242 311 4, 89 390 4, 41 194 4, 443 259 3, 79 318 3]

2 7 1 7 2 1 1 4 5 5 5 7 2 8 3 7 
[330 334 2, 362 330 3, 422 290 2, 474 298 4, 346 358 4, 362 366 2, 462 366 3, 470 250 4, 154 14 2]
[222 325 4, 120 169 4, 82 76 3, 421 72 3, 379 341 2, 372 288 3, 379 177 4, 426 11 4, 482 225 3, 328 144 2, 373 376 2, 242 268 3, 345 160 3, 143 153 2, 2 193 4, 441 222 3, 391 320 2, 17 125 2, 287 364 2, 91 226 4, 67 231 3, 269 40 4, 351 367 3, 477 98 2, 329 359 2, 103 306 2, 100 184 2]

4 7 1 7 1 1 8 4 5 5 5 7 2 8 3 7 
[330 334 3, 414 338 2, 454 374 2, 474 314 3, 286 114 3, 342 162 4, 378 166 4, 458 234 3, 362 166 2, 394 206 2]
[493 172 2, 229 112 3, 267 339 2, 186 101 4, 273 350 2, 293 119 4, 127 7 2, 478 360 4, 6 120 3, 29 311 2, 484 332 2, 50 385 4, 65 45 4, 62 333 2, 355 382 2, 120 194 2, 362 279 4, 146 128 2, 452 315 4, 333 67 3, 310 16 4, 217 325 3, 125 238 3, 72 284 3, 263 248 2, 415 273 3, 17 199 4, 392 239 4, 278 227 4, 96 265 4]

4 7 1 7 1 1 8 4 5 5 5 7 2 8 3 7 
[330 334 4, 362 310 4, 334 386 3, 274 358 3, 410 366 3, 470 378 4, 438 378 4, 366 322 4, 486 374 3, 486 298 3]
[469 256 4, 317 11 3, 270 49 2, 59 226 3, 229 69 2, 279 379 4, 342 352 2, 254 233 3, 241 165 4, 211 292 2, 28 65 4, 28 35 3, 493 48 3, 471 331 3, 391 182 2, 396 113 4, 278 62 3, 202 253 4, 428 245 4, 51 80 4, 83 324 4, 355 339 2, 134 288 3, 29 122 3, 470 247 4, 137 71 2, 221 94 2, 312 83 2, 332 130 2, 307 155 3]

4 7 1 7 1 2 8 4 5 5 5 7 2 8 3 7 
[330 334 4, 298 302 3, 246 298 4, 182 246 2, 166 254 3, 178 158 3, 254 242 2, 270 186 4, 242 194 4, 322 222 4, 366 218 3]
[481 187 2, 363 158 4, 451 102 4, 377 209 4, 429 77 4, 281 283 3, 150 343 2, 377 245 4, 301 396 3, 133 114 3, 234 84 2, 17 317 2, 107 272 2, 254 166 3, 85 335 3, 15 121 4, 358 9 3, 46 247 2, 315 386 2, 489 176 3, 467 169 4, 204 166 2, 469 29 3, 492 139 3, 427 257 4, 192 228 3, 359 378 4, 147 219 4, 122 84 2, 206 381 4, 222 308 4, 226 63 3, 369 197 4]

4 7 1 7 1 2 8 4 5 5 5 7 2 8 3 7 
[330 334 3, 358 318 2, 326 318 2, 242 262 2, 294 386 3, 482 270 2, 482 202 2, 482 318 3, 414 314 3, 462 330 2, 486 238 3, 238 194 2]
[181 226 4, 395 332 3, 353 398 2, 82 105 3, 155 319 3, 197 393 3, 55 98 4, 411 66 2, 438 218 3, 300 59 3, 365 0 2, 289 313 2, 140 156 3, 325 370 4, 350 134 2, 251 128 3, 97 69 2, 176 308 4, 377 185 2, 5 13 2, 440 66 3, 224 22 4, 255 180 4, 249 167 4, 258 248 4, 448 165 2, 267 292 3, 477 335 4, 258 144 2, 198 270 4, 338 398 2, 136 385 3, 460 56 4, 378 97 3, 445 80 4, 358 294 2]

